###########!#######
#11111111#11@11111#
#111S#111#11111111##
#11111111#111111111#
###1######D#111111##
#1#1#1111#1#1######
#1111111111#1
############1
#1111111111#1
#1111111111#1
#1111111111#1
#1111111111#1
#1111111111#1
############