###%%##&####
#1111212111#
#1112121211#
#11212S2121#
#1111121211%
#11111@1222%
&1111111222#
#1111111111#
#&#%%##&####
