###########!#######
#11111111#11111111#
#111S#111#1111S111##
#11111111#111SSS111#
###1######D#11S111##
#1#@#1111#1########
#1111111111#
############