###########!#######
#11111111#11111111#
#1111#111#11111111##
#11111111#111111111#
###1######D#111111##
#1#1#1111#1#1######
#1111111111#111111#
##1#########111111#
#1111#######111111#
#1S11#11111#111111#
#11@1#11111#111111#
#1111#111111111111#
#1W11#######111111#
###################