###&#%######%###%####&####%###&####%###&###%##&#######%#
#112111S11111121111S11111S11211211111111211111111111111#
#1121121111S111121111111111111211112S111121S11111S11111%
#1122111211121122111211111s11S11111112112112111111111G1#
%1111111SS111S1121111211111111111S111112112211211111111#
#11@11122111112111S11111s11111S11S1112111111111111W1111%
%11112111111S12111S1111111111111111111111111G1111111111#
#1111211122111111111s11122211SS1111211S111111121111G111#
#11211121S1111111111s11111S111221112111S111112111111111#
##&#%####%####%##&######%###&#####%##&##%#######%#######