##!%&##&####...........##!%&##&######
#Z211112112%...........#121121211222%
%##%&##%###%###%#%###!#%1211121211!##
#11212111212211121111211211111211111#
#2111121211112211111221111121G111SW1#
!21111@11221211112111121111111111211#
&#%##%&#%###%###&#&###%#%&#211121121#
#s2111B111S#.............#2111211111!
#&#&%##&###%.............#&#&%11&###%