###########!#######
#11111111#11111111#
#11111111#111@1111##
#11111111#111S11111#
###1######11111111##
#1#1#111111########
#1111111111#
############