###################
#11111111#11111111#
#11111111#11111111##
#@1111111#111111111#
###1######11111111##
#1#1#111111########
#1111111111#
############